111111111111111111111111
1000000000000000P0000001
100000C00C0C0C0C0C0C0CC1
100000000000000000000001
100000000000000000000001
10000000000E000000C0C001
100000000000000000000001
111111111111111111111111
